NO ./img/sBackroom.xpm
SO ./img/sBackroom.xpm
WE ./img/sBackroom.xpm
EA ./img/sBackroom.xpm

C 209,210,157
F 191,158,76

11111111111111111
10100010000000001
10001000001011101
10111111111000001
10001000001011111
11101011101000001
10101000101000001
10101110101000001
10000010N00011111
11111110111000001
10000000100000001
10111111101000001
10100000001111111
10001111111000001
10111000001111101
10000000000000001
11111111111111111
