NO ./img/sExit.xpm
SO ./img/sKey0.xpm
WE ./img/sTile.xpm
EA ./img/sWall.xpm
F 85,85,85
C 170,170,170
111111
1S0101
101001
1100N1
111111
