NO ./img/sWall1.xpm
SO ./img/sWall2.xpm
WE ./img/sWall3.xpm
EA ./img/sWall4.xpm
F 85,85,85
C 170,170,170
111111
1S0101
101001
1100N1
111111
