NO ./img/sExit.xpm
SO ./img/sKey0.xpm
WE ./img/sTile.xpm
EA ./img/sWall.xpm
F 85,85,85
C 170,170,170
111111
100101
101001
110001
111111
