NO ./img/sTeam.xpm
SO ./img/sTeam.xpm
WE ./img/sIdSoftware.xpm
EA ./img/sIdSoftware.xpm
F 85,85,85
C 170,170,170
 111111111111111
10000000000000001
10000000000000001
10000000000000001
10000000000000001
10000000000000001
10000000N00000001
10000000000000001
10000000000000001
10000000000000001
10000000000000001
10000000000000001
 111111111111111
