NO ./img/sWall1.xpm
SO ./img/sWall2.xpm
WE ./img/sWall3.xpm
EA ./img/sWall4.xpm
C 135,206,235
F 128,128,128
1111111111111
1010001000001
1000100000101
1011111111101
1000100000101
1110101110101
1010100010101
1010111010101
1000001010001
1111111011101
10000000100N1
1111111111111
