NO ./img/sWall1.xpm
SO ./img/sWall2.xpm
WE ./img/sWall3.xpm
EA ./img/sWall4.xpm
C 135,206,235
F 128,128,128
1111111111111
10000000000001
1000000000001
1000100000001
1000010000001
1000000000001
10000S0000001
11111111111111